11111111111111111111
100000010001C0100001
10111011111010111101
10100000001000000101
10111010101111010101
10001000000000X00001
11101011101110101111
10001000001000001001
11111010111011111111
10P000C0000000000001
10111010101111011101
11111011101110011111
10001000000000000001
10000000100000000001
101111101011111101E1
11111111111111111111
