1111111111111111111111111
10000010C0000000000C00001
1000001111100000000000001
1000P00000000000000000001
1000000000000000000E00001
1111111111111111111111111
