111111111111
10000P010C01
101111010001
100001010001
101000010001
101110010001
100001110001
101111000101
100000010C01
1011111100E1
111111111111