1111111111111111111111111
1P000000100C10001000100C1
1011111010111110101010101
1010001000000000001010101
1010111110111011111011101
100010C010001000101000001
1110101111101111101111111
1010001000000010000010001
1010111110101110101010101
100000001C100000101000101
1110111111101111101110101
1000101010101000000010101
1011101010101010101110101
1C00100000001C10100C101E1
1111111111111111111111111
